GGGGGGGGGGGGGGGGGGGGGGGGGGGGGTWWTTTTGGGGGGGGGGGGGGG
GGGGGGGGGGGGGGGCCCGGGGGGGGGGGTWWWWWTGGGGGGGGGGGGGEG
EGGGCGGGGGGMMMMEGGGGGGGGTGGGGTWWWWWTGGGGGGGGGGGGGGG
GGGGCGGGGMMMMMMMGGGGGGGGTGGGGTTTTWWTGGGGGGGGGGGTTGG
GGGGCGGGMMMMMMMMMMGGGGGGTGGGGGGGTWWTGGGGGGGGGGGGGGG
GGGGGGGMMMMMLLMMMMMGGGGGGGGGGGGGGGGGGGGPGGGGGGGGGGG
GGGGGGGGMMMMLLLLLLMMGGGGGGGGGGGGTWWTTTGGGGGGGGGGGGG
GGCGGGGHHMMMLLLLLLMMMGGGGGGGGGGGTWWWWTGGGGGGGGGGGGG
GGCGGGGSSGMMMMMLLLMMMMGGGGGGGGGGGGTWWTGGGGGGGGGGGGG
GGCGGGGGGGGGGGGGLLLLLLLGGGGGGGGGGGTWWTGGGGGGGGGGGGG
GGGGGGGGGGGGGGGGLLLLLLLEGGGGGGGGGGTWWTGGGGGGGGGGGGG
GGGEGGGGGGGGGGGGGGGGLLLGGGGGGGGGGGTWWTGGGGGGGGGGGGG
GGGGGGGGGGGGGGGGGGGGLLLGGGGGGGGGGGTWWTGGGGGGGGGGGGG